===== Переименования =====

Герои:
	Прокажённый = Прокажник [готово]
	Дикарка = Дикаристка [готово]
	Разбойник = Дорожник [готово]
	Чумница = Доктор Секс [готово]
	Расхитчица = Расхихитчица [готово]
	Шут = Король и шут [готово]
	Воитель = MegaDedx [готово]
	Оккультист = Приколист [готово]
	Беглянка = Побежчица [готово]
	Весталка = Весталочь [готово]
	Дуэлянка = Негритянка
	Крестоносец = Рыцарь
	Выродок = Абама (потому что Abomination)
	Наёмник = Наёбник [готово]

Локации:
	Староречье = Краснодар [готово]
	Поградье = -Вьетнам- Якутия [готово]
	Морготье = Питер [готово]
	Смрадье = Ростов [готово]
	Чернолесье = Новосибирск [готово]
	Гора = Гора Фудзи [готово]
	Тундра = Норильск [готово]
	Долина = Самара [готово]
	Катакомбы = Метро

Остановки:
	Проход забвения = ?
	Берлога = Фурри притон [готово]
	Барахольщик = Барыга [готово]

Враги:
	Космикон, Еретик = Хентай [готово]
	Тварь = Фурри [готово]
	Изувер = Якут [готово]
	Рыбочеловек = Питеровец [готово]
	Кадавр = Сибиряк [готово]
	Вепрь = Свин [готово]
	Слизень = Кисель
	Несыть = Жрун [готово]
	Дохляк = Шкилет [готово]
	Бандит = Бандит [не меняется]
	_military = ?
	Тьманник = Тимоха [готово]
	Смерть = Смерть [не меняется]
	Коллекционер = Коллектор [готово]
	Левиафан = Паша [готово]
	Генерал = Генерал Военкомата
	Дитя урожая = Кроха Олег

Основные штуки:
	Дилижанс = Маршрутка [готово]
	Аксессуары = Обвесы[готово]
	
	Реликвия = Тенге [готово]
	Безделицы = Ширпотреб [готово]

Королевства:
	Ведьма = ?
	Зверочеловек = ?

	поменять inn_title_kingdom_inn!!!

Трактир:
	Школа закалки = ПТУ [готово]
	Очки закалки = Подгон преподу [готово]
	Лекарский кабинет = Поликлиника [готово]
	Путевой журнал = Хроники Андрея [готово]
	Чёрная лавка = Базар [готово]

Черты характера:
	Кровожадность = Дамагер

===== Заметки =====

"Кто плохо подрочит - будет передрачивать." [готово]
"Пристойность тихо"... [готово]
skill_name_failure !!!!!!!!!!!

Командир (Warlord) = Джаггернаут
	Паро = Раздавить шкилета
	Секаре = Я иду за тобой
	Когортор = Нанесение смазки для траха
	Колафус = Фистинг

===== Закладки =====
ru.po - строка 32905
!! 54591 !!
!! 54898 !!
!! 80478 !!


//////////////////////////////////////////

Миша:

На данный момент переделываю строчки с тегом story_bark 
начал с 96927 остановился на 97375 (там работы как сверху, так и снизу предстоит ещё много, я не думаю, что буду переводить вообще все, некоторые фразы контекстуально менять не хочется, тем не менее смешинку добавить хочется)

В планах - поработать над vo_driving_biome и vo_altar_of_hope потому что фразы с дилижанса/маршрутки, я думаю, должны быть переделаны почти полностью.
